######################
#S      ########## ###
#### ##    ####      #
#### #####>     ####A#
####   ######1######E#
######################