######################
#S      ########## ###
#### ##   V####      #
#### #####      ####A#
####   ######1######E#
######################